%%%%%%%%%%%%%%%%%%%%
%    %        %    %
% %% % %%  %% % %% %
%       G GG%      %
% % %% %% %%% %% % %
% %    %    % %  % %
% % %% % %% % % %% %
% %      P    %    %
%%%%%%%%%%%%%%%%%%%%
