%%%%%%%%%%%%%%%%%%%%
%    %        %    %
% %% % %%%%%% % %% %
% %  G           % %
% % %% %%  %% %% % %
%      %G   %      %
% % %% %%%%%% %% % %
% %              % %
% %% % %%%%%% % %% %
%    %   P    %    %
%%%%%%%%%%%%%%%%%%%%
