%%%%%%%%%
% P    G% 
% % %G%%%  
%G    %%% 
%%%%%%%%%
