%%%%%%%%%%%%%%%%%%%%%%%%%
%   P                   %
%                       %
%                       %
%                     G %
%                       %
%                       %
%                       %
%%%%%%%%%%%%%%%%%%%%%%%%%
