%%%%%%%%%%%%%%%%%%%%
%      %G   %      %
% %%   %%  %%   %% %
% %  %        %  % %
% %% % %%%%%% % %% %
%G       P        G%
%%%%%%%%%%%%%%%%%%%%
