%%%%%%%%%%%%%%%%%%%%
%      %G   %      %
% %%   %%  %%   %% %
% %  %        %  % %
% %% % %%%%%% % %% %
%        P        G%
%%%%%%%%%%%%%%%%%%%%
