%%%%%
%   %
% G %
%   %
%   %
%   %
%   %
%   %
%P  %
%%%%%
