%%%%%%%%
%   P G%
%G%%%%%%
%      %
%%%%%%%%
