%%%%%%%%%%%%%%%%%%%%
%    %        %    %
% %% % %%  %% % %% %
% %     %  %     % %
% % %% %%  %% %% % %
%       GGGG% %    %
% %    %%%%%% %  % %
% %    %    % %  % %
% %    % %%%% %  % %
% %           %  % %
% %% % %%%%%% % %% %
%    %   P    %    %
%%%%%%%%%%%%%%%%%%%%
